の	の	indicates possessive / nominalizes verbs and adjectives / substitutes for "ga" in subordinate phrases / (at sentence-end, falling tone) indicates a confident conclusion / (at sentence-end) indicates emotional emphasis / (at sentence-end, rising tone) indicates question
を	を	indicates direct object of action / indicates subject of causative expression / indicates an area traversed / indicates time (period) over which action takes place / indicates point of departure or separation of action / indicates object of desire, like, hate, etc.
に	に	at (place, time), in, on, during / to (direction, state), toward, into / for (purpose) / because of (reason), for, with / by, from / as (i.e. in the role of) / per, in, for, a (e.g. "once a month") / and, in addition to / if, although
が	が	indicates sentence subject (occasionally object) / indicates possessive (esp. in literary expressions) / but, however, still, and / regardless of, whether (or not)
は	は	indicates sentence topic / indicates contrast with another option (stated or unstated) / adds emphasis
と	と	if, when / and / with / used for quoting (thoughts, speech, etc.) / promoted pawn / indicates a question
で	で	at, in / at, when / by, with / and then, so / and, then / let me tell you, don't you know
第	だい	prefix for forming ordinal numbers
する	する	to do, to carry out, to perform / to cause to become, to make (into), to turn (into) / to serve as, to act as, to work as / to wear (clothes, a facial expression, etc.) / to judge as being, to view as being, to think of as, to treat as, to use as / to decide on, to choose / to be sensed (of a smell, noise, etc.) / to be (in a state, condition, etc.) / to be worth, to cost / to pass (of time), to elapse / to place, or raise, person A to a post or status B / to transform A to B, to make A into B, to exchange A for B / to make use of A for B, to view A as B, to handle A as if it were B / to feel A about B / verbalizing suffix (applies to nouns noted in this dictionary with the part of speech "vs") / creates a humble verb (after a noun prefixed with "o" or "go") / to be just about to, to be just starting to, to try to, to attempt to
た	た	did, (have) done / (please) do
な	な	don't / do / hey, listen, look, say / now, ..., well, ..., I tell you!, you know / wow, ooh / right?, isn't it?, doesn't it?, don't you?, don't you think?
条	すじ, スジ	muscle, tendon, sinew / vein, artery / fiber, fibre, string / line, stripe, streak / reason, logic / plot, storyline / lineage, descent / school (e.g. of scholarship or arts) / aptitude, talent / source (of information, etc.), circle, channel / well-informed person (in a transaction) / logical move (in go, shogi, etc.) / ninth vertical line / seam on a helmet / gristly fish paste (made of muscle, tendons, skin, etc.) / social position, status / on (a river, road, etc.), along / counter for long thin things, counter for roads or blocks when giving directions / street (in Osaka) / (Edo period) counter for hundreds of mon (obsolete unit of currency)
こと	こと	particle indicating a command / particle indicating mild enthusiasm / particle indicating a gentle interrogative / particle used to soften a judgment or conclusion
である	である	be, is
場合	ばあい	case, situation
も	も	too, also, in addition, as well, (not) either (in a negative sentence) / both A and B, A as well as B, neither A nor B (in a negative sentence) / even, as much as, as many as, as far as, as long as, no less than, no fewer than / even if, even though, although, in spite of / further, more, again, another, the other
さ	さ	-ness / indicates assertion / come, come now
ます	ます	used to indicate respect for the listener (or reader) / used to indicate respect for those affected by the action
その	その	that, the / part (as in "part two") / um ..., er ..., uh ...
など	など	et cetera, etc., and the like, and so forth / or something / the likes of / for example, for instance, for one
等	など	et cetera, etc., and the like, and so forth / or something / the likes of / for example, for instance, for one
る	る	verb-forming suffix
し	し	and, besides, moreover, what's more, not only ... but also / because, since / the thing is, for one thing
では	では	then, well, so, well then / if not ..., unless ... / bye then
した	した	below, down, under, younger (e.g. daughter) / bottom / beneath, underneath / just after, right after / inferiority, one's inferior (i.e. one's junior) / trade-in / preliminary, preparatory
ある	ある	to be, to exist, to live / to have / to be located / to be equipped with / to happen, to come about
から	から	from (e.g. time, place, numerical quantity), since / from (originator), by / because, since / out of (constituent, part) / through (e.g. window, vestibule) / after, since / expresses sympathy or warning
や	や	such things as ..., and ... and / the minute (that) ..., no sooner than ..., as soon as / be, is / o, oh / huh, what / hi / yes, what? / yes?, no?, is it?, isn't it?
て	て	you said, he said, she said, they said / if ... then / do you seriously think that / I already told you, you should know by now that, of course / the said ..., said ... / says that ... / I hear that ... / as for the term ... / as for ...
項	うなじ	nape (of the neck), nucha
という	という	called, named, that says, that / as many as, as much as / all ..., every single ...
この	この	nine, 9
には	には	to, for, on, in, at / in order to, for / as for, regarding / while it is (was) the case that ..., indeed ... (but), certainly ... (but)
年	とし	year / age, years / past one's prime, old age
って	って	you said, he said, she said, they said / if ... then / do you seriously think that / I already told you, you should know by now that, of course / the said ..., said ... / says that ... / I hear that ... / as for the term ... / as for ...
について	について	concerning, regarding / per (e.g. 100 yen per person), for every
です	です	be, is
又は	または	or, either ... or ...
して	して	by (indicating means of action), as (a group, etc.) / indicates the agent in a causative construction / acts as a connective indicating a state or condition / adds emphasis / and, so, then
規定	きてい	stipulation, prescription, provision, regulation, rule / normal (unit of normality) / compulsory exercise (in gymnastics), compulsory routine, compulsory dance (figure skating), (a) compulsory
てい	てい	appearance, air, condition, state, form
ら	ら	lightweight fabric or clothing, silk gauze, thin silk / Latin (language)
者	もの, もん	person
及び	および	and, as well as
として	として	as (i.e. in the role of), for (i.e. from the viewpoint of) / apart from... (used to change the topic) / even (e.g. "not even a single person") / thinking that..., trying to...
条文	じょうぶん	text, provisions (act, treaty)
してい	してい	servant, janitor, messenger
による	による	by means of, due to, because of, according to
号	ごう	number, edition, make, model, issue, part of that group / sobriquet, pen-name / size (of printing types, canvases, knitting needles, etc.) / suffix attached to names of ships, trains, airplanes, etc.
において	において	in, on, at (place), as for, regarding
あり	あり	ant
ので	ので	that being the case, because of ..., the reason is ..., given that ...
される	される	to be done (to someone or something) / to do, to be doing
当該	とうがい	appropriate (e.g. authorities), concerned, relevant, said, aforementioned, competent, applicable, respective
ド	ド	doh (1st note of a major scale in movable-do solfège), do / C (note in the fixed-do system)
日	ひ	day, days / sun, sunshine, sunlight / (the) day, daytime, daylight / date, deadline / (past) days, time (e.g. of one's childhood) / case (esp. unfortunate), event
ン	ン	some (at the start of a number in place of a digit)
必要	ひつよう	necessary, needed, essential, indispensable / necessity, need, requirement
いる	いる	to shoot (arrow, bolt, dart)
関する	かんする	to concern, to be related
人	じん	-ian (e.g. Italian), -ite (e.g. Tokyoite) / -er (e.g. performer, etc.), person working with ... / man, person, people
とき	とき	regular (stops at every station) Jouetsu-line Shinkansen
ため	ため	the same (age, social status), peer
また	また	crotch, crutch, groin, thigh / fork (in a tree, road, river, etc.), tines (of a fork)
月	つき	Moon / month / moonlight / (a) moon, natural satellite
他	ほか	other (place, thing, person), the rest, et al. / outside, beyond / nothing except, nothing but, nothing apart from, nothing aside from, no choice (but to) / besides..., in addition to...
ト	ト	7th in a sequence denoted by the iroha system / 7th note in the diatonic scale (used in key names, etc.), G
により	により	similarity
す	す	be, is
とは	とは	indicates word or phrase being defined / used for quoting (thoughts, speech, etc.) / with / (not) as much as, (not) so much as / the fact that, to think that, such a thing as
であ	であ	to be
コ	コ	counter for articles / counter for military units / individual
く	く	section (i.e. of text), sentence, passage, paragraph / phrase / verse (of 5 or 7 mora in Japanese poetry; of 4, 5, or 7 characters in Chinese poetry) / haiku, first 17 morae of a renga, etc. / maxim, saying, idiom, expression
解説	かいせつ	explanation, commentary, exposition, elucidation
います	います	to be / to go, to come
書	ふみ	letter, writings
によって	によって	according to, by (means of), due to, because of
参照	さんしょう	reference (e.g. to a dictionary, passage, footnotes), consultation, comparison / browsing (to a file or folder)
き	き	yellow
り	り	understood, OK, roger
ことができる	ことができる	to be able (to), to be possible (to)
へ	へ	to, towards, for
中	なか	inside, interior / among, within / middle, center, centre / during, while, middle, midst, amid / interval, gap / mean, average / second (of three, e.g. sons, volumes), middle / medium grade, medium quality / red-light district
用	よう	business, task, errand, engagement / use, purpose / for the use of ..., used for ..., made for ... / call of nature, excretion
上	うえ	above, over, up / top, summit, upper part, head (e.g. of a staircase) / surface, on (top of) / the above (in a piece of writing), earlier part / superior, better, higher (position, rank, etc.), upper (class) / elder, older, senior / with respect to ..., in terms of, as far as ... is concerned, when (e.g. drunk) / besides ..., in addition to ..., on top of ..., as well as ... / after ..., upon ..., on ..., with (e.g. full awareness), as a result of ... / since ..., now that ..., because ... / honorable, venerable, dear / emperor, sovereign, shogun, daimyo
ロ	ロ	2nd in a sequence denoted by the iroha system, 2nd note in the diatonic scale (used in key names, etc.)
以下	いか, いげ	not exceeding, and downward, ... and below / below (e.g. standard), under (e.g. a level) / the below-mentioned, the following, the rest
法	のり	rule, law, regulation / model, pattern / teachings of Buddha, Buddhist doctrine / transverse measurement, measurement across / side-slope, slope
関数	かんすう	function / function (programming)
問題	もんだい	question (e.g. on a test), problem / problem (e.g. societal, political), question, issue, subject (e.g. of research), case, matter / question (i.e. doubt) / public discussion, controversy / trouble, problem, inconvenience, difficulty
もの	もの	indicates reason or excuse / indicates dissatisfaction, indicates desire to be pampered or indulged
か	か	indicates a question / or, whether or not / some- (e.g. something, someone) / hmm, huh / very / -al, -ial, -ic, -ical, -ish, -y / in that way
い	い	strengthens a question, assertion, etc.
方法	ほうほう	method, process, manner, way, means, technique
でも	でも	but, however, though, nevertheless, still, yet, even so, also, as well / even / however, no matter how, even if, even though / ... or something / either ... or ..., neither ... nor ... / pseudo-, quack, in-name-only / for lack of anything better to do
しま	しま	four-of-a-kind
定める	さだめる	to decide, to determine / to establish, to lay down, to prescribe, to provide, to stipulate / to bring peace (to), to make peaceful
意味	いみ	meaning, significance, sense
なければならない	なければならない	have to do, must, should, ought to
これ	これ	hey, oi, come on, look, listen
ない	ない	not / emphatic suffix
日本	にほん, にっぽん	Japan
数	しばしば	often, again and again, frequently, repeatedly
係る	かかる	to be the work of, to be the result of, to be done by / to concern, to affect, to involve, to relate to
行	ぎょう	line (of text), row, verse / carya (austerities) / samskara (formations) / semi-cursive style (of writing Chinese characters), running style
ば	ば	if ... then, when / and / why don't you...? / the more (one does something) / because, since
いて	いて	archer, shooter, bowman
登記	とうき	registry, registration
しない	しない	in the city, within the city
法律	ほうりつ	law
額	がく	(picture) frame, framed picture / amount (esp. of money), sum
でき	でき	workmanship, craftsmanship, execution, finish / grades, results, score, record / quality (e.g. of a crop) / dealings, transactions
ません	ません	not
前後	ぜんご	front and rear, front and back, before and behind, back and forth / before and after / around, about, approximately / order, context / consequences / just when, around the time of / inversion, reversion, getting out of order / co-occurring, happening at the same time
しかし	しかし	however, but
同じ	おなじ, おんなじ	same, identical, equal, uniform, equivalent, similar, common (origin), changeless, alike / anyway, anyhow, in either case
シ	シ	ti (7th note of a major scale in movable-do solfège), si / B (note in the fixed-do system)
まで	まで	until (a time), till, to, up to / to (a place or person), as far as / to (an extent), up to, so far as, even / only, merely
とする	とする	to try to ..., to be about to do ... / to decide to ... / to take as, to treat as, to regard as / to use for / to suppose that (such) is the case, to assume / to decide that, to think that / to make into, to change into / to feel (e.g. after sound symbolism or psychological experience word), to look, to feel like / to intend, to have the intention
なり	なり	or something, for instance ... (though there are other suitable options) / ... or ... / as soon as, right after / while still, with previous state still in effect
使	し	messenger / police and judicial chief (Heian and Kamakura periods) / klesha (polluting thoughts such as greed, hatred and delusion, which result in suffering)
次	つぎ	next, following, subsequent / stage, station
ました	ました	right under, directly below
ニ	ニ	4th in a sequence denoted by the iroha system, 4th note in the diatonic scale (used in key names, etc.)
言	げん, こと	word, remark, statement
節	せつ	occasion, time / section (of a literary work or piece of music), passage, paragraph, verse, stanza / clause / season, term / one's principles, integrity / node (of a plant stem) / (taxonomical) section / knot (nautical mile per hour)
なる	なる	that is in / who is called, that is called / that is / I see
できる	できる	to be out of, to have no more at hand
ために	ために	for, for the sake of, to one's advantage, in favor of, in favour of, on behalf of / because of, as a result of
における	における	in, at, on, as for, regarding, with regards to
型	かた, がた	type, style, model, pattern / mold, mould, model, pattern, template, impression / kata (set sequence of positions and movements in martial arts), style (in kabuki, noh, etc.), form / convention, tradition, (standard) form, formula, usage / (set) size, inches (in sizes of displays, disks, image sensors, etc.) / (taxonomical) form
なお	なお	still, yet / more, still more, greater, further / as ..., like ... / furthermore, in addition, moreover, note that ...
前	さき	point, tip, end, nozzle / head (of a line), front / first, before, ahead (of) / (the way) ahead, beyond / future / previous, prior, former, recent, last / destination, address, place where you do something / rest (e.g. of a story), continuation, remaining part / the other party
例	れい	custom, practice, habit, usual / said, aforementioned / instance, example, case, illustration, usage / precedent
値	あたい	price, cost / value, worth, merit / value
事項	じこう	matter, item, facts
語	ご	word / language / speech
となる	となる	to become, to be
指定	してい	designation, specification, assignment, appointment, pointing at
だ	だ	be, is / did, (have) done / please, do
章	しょう	chapter, section / medal, badge, insignia
二	に, ふた, ふ, ふう	two, 2
ウ	ウ	cormorant (Phalacrocoracidae spp.)
請求	せいきゅう	claim, demand, charge, application, request, billing (for a service)
式	しき	equation, formula, expression / ceremony / style / enforcement regulations (of the ritsuryō)
後	あと	behind, rear / after, later / remainder, the rest / more (e.g. five more minutes), left / also, in addition / descendant, successor, heir / after one's death / past, previous
ような	ような	like, similar to / (I) think (that), (I) have a feeling (that) / feels like, feels similar to, feels as if
すると	すると	thereupon, hereupon
せ	せ	so, really, seeming
ア	ア	ah, oh / hey!
なので	なので	because, as, since
方	かた	direction, way / person, lady, gentleman / method of, manner of, way of / care of ... / person in charge of ... / side (e.g. "on my mother's side")
受け	うけ, ウケ	popularity, favour, favor, reception / defense, defence, reputation / agreement / receiver of technique (e.g. in martial arts) / submissive partner of a homosexual relationship
掲げる	かかげる	to put up (a notice, sign, etc.), to hang out (e.g. a banner), to fly (e.g. a flag), to hoist, to raise, to display / to hold up high, to raise overhead / to tout (a principle, plan, etc.), to herald, to hold up (an ideal), to parade (e.g. a slogan) / to publish, to print, to carry (e.g. an article) / to tuck up (e.g. sleeves), to roll up / to stoke (a fire), to fan (a flame)
以上	いじょう	not less than, ... and over, ... and above, ... and upwards, ... or more / beyond (e.g. one's expectations), above, more than, further than / above-mentioned, aforementioned, foregoing / since ..., seeing that ..., now that ..., once ... / that's all, that is the end, the end
文	ふみ	letter, writings
より	より	than / from, out of, since, at, on / except, but, other than / more
考え	かんがえ	thinking, thought, view, opinion, concept / idea, notion, imagination / intention, plan, design / consideration, judgement, deliberation, reflection / wish, hope, expectation
変更	へんこう	change, modification, alteration, revision, amendment
改正	かいせい	revision, amendment, alteration
内容	ないよう	contents, content, substance, matter, detail, import
計算	けいさん	calculation, reckoning, count / forecast
だけ	だけ	only, just, merely, simply, no more than, nothing but, alone / as much as, to the extent of, enough to
各	かく	each, every, all
との	との	feudal lord / mansion, palace
ただし	ただし	but, however, provided that
定義	ていぎ	definition
第一	だいいち	first, foremost, number one / most important / best, greatest, most / above all, besides, in any case, to begin with
的	てき	-ical, -ive, -al, -ic, -y / -like, -ish, -sort of, -kind of / (something) like, along the lines of / -wise, in terms of, for, from the viewpoint of, from a ... standpoint, as far as ... is concerned / Mr., Ms., Mrs.
いた	いた	board, plank / sheet (of metal), plate (of glass), pane, slab / cutting board, chopping board / chef (esp. of high-end Japanese cuisine), cook / stage (i.e. at a theatre)
点	ちょぼ, チョボ	dot, point, mark / gidayū musicians (in kabuki)
使用	しよう	use, application, employment, utilization, utilisation
表示	ひょうじ	indication, expression, showing, manifestation, demonstration / display, displaying / representation / (copyright) attribution
ファイル	ファイル	file (for holding papers) / file (collection of documents), filing, keeping on file / file
多く	おおく	many, much, plenty, a lot / majority (of), greater part (of) / mostly, mainly, chiefly, usually, often
取り	とり	taking, taker, collecting, collector, remover, removal / last performer of the day (usu. the star performer), last performance of the day / active partner (e.g. in judo demonstration) / emphatic or formal prefix
イ	イ	1st in a sequence denoted by the iroha system, 1st note in the diatonic scale (used in key names, etc.)
期間	きかん	period, term, interval
これら	これら	these
間	あいだ, あわい	space (between), gap, interval, distance, stretch / period of time (during, while), duration, interval / between (two parties or things) / among (a group) / relations (between), relationship / midpoint, average, halfway, middle ground / due to, because of
られる	られる	indicates passive voice (incl. the "suffering passive") / indicates the potential form / indicates spontaneous occurrence / used as an honorific for others' actions
ように	ように	in order to (e.g. meet goal), so that, take care (so as) / hoping or wishing for something
行う	おこなう	to perform, to do, to conduct oneself, to carry out
内	うち	inside, within / while (e.g. one is young), during, within (e.g. a day), in the course of / among, amongst, (out) of, between / in (secret, chaos, poverty, etc.), amidst, with (e.g. success) / within oneself, one's feelings, inner thoughts / we, our company, our organization / one's home, one's family / my spouse, my husband, my wife / signed on behalf of (husband's name) by his wife / I, me / imperial palace grounds / emperor
対して	たいして	for, in regard to, per
関係	かんけい	relation, relationship, connection / participation, involvement, concern / influence, effect / sexual relations, sexual relationship / related to, connected to
前項	ぜんこう	preceding clause, previous paragraph / antecedent (of a ratio)
デ	デ	of (indicates possessive)
見	み	looking, viewing / (please) try (to)
のように	のように	like, similar to / as with, in the same way
パ	パ	pas (ballet step)
同	どう	the same, the said / likewise
マ	マ	for real
にも	にも	also, too, not ... either, as well, even / (it's not possible) no matter what, although one might wish otherwise
一	いち	one, 1 / best / first, foremost / beginning, start / a (single), one (of many) / ace (playing card) / bottom string (on a shamisen, etc.)
ここ	ここ	here, this place / this point, here, now / these past ... (e.g. three years), these last ... / the next ... (e.g. few days), these next ...
カ	カ	mosquito
判例	はんれい	(judicial) precedent
結果	けっか	result, consequence, outcome, effect / coming to fruition, bearing fruit / as a result, consequently, therefore
きない	きない	during a period, while
われ	われ	I, me / oneself / you / prefix indicating familiarity or contempt
多い	おおい	many, numerous, a lot / large amount of, large quantity of, a lot, much / frequent, common
対する	たいする	to face (each other), to be facing / to be directed toward (the future, etc.), to be in response to, to be related to / to receive (a client, etc.) / to compare with, to contrast with, to be in opposition with, to be opposed to / to confront, to oppose, to compete with
手続	てつづき	procedure, process, proceedings, formalities
以外	いがい	with the exception of, excepting, excluding
たとえば	たとえば	for example, for instance, e.g.
あっ	あっ	ah, oh / hey!
つ	つ	indicates two contrasting actions / indicates possessive (often found in place names and compound words)
文字	もじ, もんじ	letter (of alphabet), character / writing
権利	けんり	right, privilege
出	で	coming out, going out, outflow, efflux, rising (of the Sun or the Moon) / attending (work), appearing (on stage), one's turn to go on / start, beginning / origins, background, person (or item) originating from ..., graduate of ..., native of ..., member of ... (lineage) / architectural member that projects outward / highest point of the stern of a ship / amount (comprising something), amount of time or effort required to do something
レ	レ	re (2nd note of a major scale in movable-do solfège), ray / D (note in the fixed-do system)
これは	これは	as for this / hey there, see here, I say
情報	じょうほう	information, news, report, intelligence / information (data contained in characters, signals, code, etc.)
教科書	きょうかしょ	textbook, coursebook, schoolbook
なら	なら	if, in case, if it is the case that, if it is true that / as for, on the topic of / if that's the case, if so, that being the case / if possible, if circumstances allow
作成	さくせい	making (a report, plan, contract, etc.), drawing up, writing out, preparing, creating (a file, website, account, etc.)
ゲ	ゲ	exclamation of surprised disappointment, disgust, or worry (yuck, ick, ack, eeew, crap!, blech, gross)
名	な	name, given name / title / fame, renown, reputation / pretext, pretense, justification, appearance
準用	じゅんよう	to apply (the law) with necessary modifications, to apply mutatis mutandis, to apply correspondingly
定め	さだめ	law, rule, regulation, provision, decision, appointment, arrangement, agreement / destiny, fate, karma
行為	こうい	act, deed, conduct
本	もと	origin, source / base, basis, foundation, root / cause / ingredient, material, base, mix, stock / (someone's) side, (someone's) location / original cost (or capital, principal, etc.) / (plant) root, (tree) trunk / first section of a waka / counter for blades of grass, tree trunks, etc., and for falcons (in falconry) / handle (chopsticks, brush, etc.), grip
時	とき	time, hour, moment / occasion, case / chance, opportunity, season / the times, the age, the day / tense
会社	かいしゃ	company, corporation / workplace
決定	けってい	decision, determination
第二	だいに	second
目的	もくてき	purpose, goal, aim, objective, intention
試験	しけん	examination, exam, test / trial, experiment, test
令	れい	command, order, dictation / nth year in the Reiwa era (May 1, 2019-)
または	または	or, either ... or ...
事	こと, こん	thing, matter / incident, occurrence, event, something serious, trouble, crisis / circumstances, situation, state of affairs / work, business, affair / after an inflectable word, creates a noun phrase indicating something the speaker does not feel close to / nominalizing suffix / pretending to ..., playing make-believe ... / alias, also known as, otherwise known as, or / necessity, need / you should ..., I advise that you ..., it's important to ...
部分	ぶぶん	portion, section, part
平成	へいせい	Heisei era (1989.1.8-2019.4.30)
ください	ください	please (give me) / please (do for me)
三	さん, み	three, 3
円	えん	yen (Japanese monetary unit) / circle
若しくは	もしくは	or, otherwise
国	くに	country, state / region / national government, central government / home (i.e. hometown, home country) / province (of Japan) / land, earth
分	ふん	minute (unit of time) / fun (one tenth of a monme, 5.787 grains)
得	とく	profit, advantage, benefit, gain / rebirth in paradise, entering nirvana
業務	ぎょうむ	business, affairs, duties, work, procedure, task, action, function, (business) operations, operational
実行	じっこう	execution (e.g. of a plan), carrying out, practice, action, implementation, fulfillment, realization
管理	かんり	control, management (e.g. of a business)
ていない	ていない	grounds, premises
種類	しゅるい	variety, kind, type, category / counter for kinds, species, etc.
申請	しんせい	application, request, petition
説明	せつめい	explanation, exposition, description, account, caption, legend
もし	もし	excuse me! (when calling out to someone)
表	おもて	surface / face (i.e. the visible side of an object) / front (of a building, etc.), obverse side (i.e. "head") of a coin / outside, exterior / appearance / public / first half (of an inning), top (of an inning) / cover (for tatami mats, etc.) / foreground / Omotesenke school of tea ceremony
特定	とくてい	specific, particular, designated, special / specifying, designating, identifying, pinpointing
たち	たち	mansion, palace, manor house, castle / nobleman, noblewoman, dignitary / cabin (on a boat, carriage, etc.)
させる	させる	to make (someone) do / to allow (someone) to do
時間	じかん	time / hour / period, class, lesson
変数	へんすう	variable
目	め	eye, eyeball / eyesight, sight, vision / look, stare, gaze, glance / notice, attention, observation, eyes (of the world, public, etc.) / an experience / viewpoint / discrimination, discernment, judgement, eye (e.g. for quality) / appearance / chance to succeed, possibility / spacing (between crossed strands of a net, mesh, etc.), opening, stitch, texture, weave / grain (of wood) / eye (of a storm, needle, etc.) / intersection (on a go board), square (on a chess board) / dot (on a dice), pip, rolled number / graduation, division (of a scale) / tooth (of a saw, comb, etc.) / ordinal number suffix / somewhat, -ish / point (e.g. of change)
基準	きじゅん	standard, basis, criterion, norm, reference, datum
そして	そして	and, and then, thus, and now, and finally
一部	いちぶ	one part, one portion, one section, some / one copy (e.g. of a document)
事業	じぎょう, ことわざ	project, enterprise, business, industry, operations, venture, service / act, deed, conduct
存在	そんざい	existence, being, presence
お	お	oh! (expression of slight surprise)
登録	とうろく	registration, accession, register, entry, record
株式会社	かぶしきがいしゃ	stock company, corporation, kabushiki kaisha, KK
言語	げんご, ごんご, げんきょ	language
理由	りゆう, わけ	reason, pretext, motive
適用	てきよう	applying (e.g. a technology), adoption
利用	りよう	use, utilization, utilisation, application
高校	こうこう	senior high school, high school
株式	かぶしき	share (in a company), stock
つの	つの	horn, antler / antenna, feeler, tentacle (e.g. of a snail) / horn-like projection (e.g. peaks of whipped cream)
大学	だいがく	university, college / former imperial university of Japan (established under the ritsuryō system for the training of government administrators) / the Great Learning (one of the Four Books)
つまり	つまり	that is to say, that is, in other words, I mean, that (this, it) means / in short, in brief, to sum up, ultimately, in the end, in the long run, when all is said and done, what it all comes down to, when you get right down to it, basically / clogging, obstruction, stuffing, (degree of) blockage / shrinkage / end, conclusion / dead end, corner / distress, being at the end of one's rope
標準	ひょうじゅん	standard, level, norm
系	けい	system, lineage, group / corollary / system (range of strata that correspond to a particular time period) / (taxonomical) series
それぞれ	それぞれ	each, respectively
物	もの, もん, モノ	thing, object, article, stuff, substance / one's things, possessions, property, belongings / things, something, anything, everything, nothing / quality / reason, the way of things / used to emphasize emotion, judgment, etc., used to indicate a common occurrence in the past (after a verb in past tense), used to indicate a general tendency, used to indicate something that should happen / item classified as ..., item related to ..., work in the genre of ... / cause of ..., cause for ... / somehow, somewhat, for some reason / really, truly
このよう	このよう	like this, this sort, this way
形	かたち, よう	form, shape, figure / visage
特例	とくれい	special case, exception
対	たい	opposite, opposition / versus, vs., v. / to (e.g. "winning a game five to three") / equal footing, equal terms / against ..., anti-, toward ..., to ...
命令	めいれい	order, command, decree, directive / (software) instruction, statement
契約	けいやく	contract, compact, agreement
処分	しょぶん	disposal, throwing away, selling off / dealing with (a problem), measure / punishment, penalty / putting down (e.g. diseased animal)
ハ	ハ	third in a sequence denoted by the iroha system, third note in the diatonic scale (used in key names, etc.)
記述	きじゅつ	description, account
知	ち	wisdom / jnana (higher knowledge)
英語	えいご	English (language)
ましょう	ましょう	I'll / let's / probably
ラ	ラ	la (6th note of a major scale in movable-do solfège), lah / A (note in the fixed-do system)
水	みず, み	water (esp. cool, fresh water, e.g. drinking water) / fluid (esp. in an animal tissue), liquid / flood, floodwaters / water offered to wrestlers just prior to a bout / break granted to wrestlers engaged in a prolonged bout
たの	たの	indicates emotion, admiration, emphasis, etc.
第三	だいさん	the third
ことに	ことに	especially, particularly, unusually, above all / additionally
発生	はっせい	occurrence, incidence, outbreak, birth (e.g. of civilization) / generation (of power, heat, etc.), production / ontogeny, development, growth, breeding
んで	んで	that being the case, because of ..., the reason is ..., given that ...
関連	かんれん	relation, connection, relevance
義務	ぎむ	duty, obligation, responsibility
数学	すうがく	mathematics
ソ	ソ	so (5th note of a major scale in movable-do solfège), soh / G (note in the fixed-do system)
ではな	ではな	projecting part (of a headland, etc.) / moment of departure, (on the) point of going out / outset, start, beginning
および	および	and, as well as
とか	とか	and the like, such as, among other things, and so on / or something, something like, a (certain) / I hear that ..., people say that..., rumour has it that ... / or something, something like, or whatever
だろう	だろう	seems, I think, I guess, I wonder, I hope / right?, don't you agree?, I thought you'd say that!
確認	かくにん	confirmation, verification, validation, review, check, affirmation, identification
め	め	no!, don't!, tsk!
力	ちから	force, strength, might, vigour, vigor, energy / capability, ability, proficiency, capacity, faculty / efficacy, effect / effort, endeavours, endeavors, exertions / power, authority, influence, good offices, agency / support, help, aid, assistance / stress, emphasis / means, resources
ず	ず	s (pluralizing suffix), es / 's (possessive suffix), s', es'
土地	とち, どおじ, どじ, どち	plot of land, lot, soil / locality, region, place
制限	せいげん	restriction, restraint, limitation, limit
ており	ており	handwoven, handspun, weaving by hand
それ	それ	there!, look! / go on!, right!, here goes!
届出	とどけで	report, notification
個	こ, コ	counter for articles / counter for military units / individual
ではない	ではない	is not, am not, are not
薬理学	やくりがく	pharmacology
有する	ゆうする	to have, to possess, to own, to be endowed with
問	とい	question, query
読み	よみ	reading / reading (of a kanji, esp. kun reading) / reading (e.g. of a situation), insight, judgment, interpretation, prediction, calculation
いう	いう	to do up (hair), to dress, to arrange / to tie, to bind, to fasten, to make (a fence)
使う	つかう	to use (a tool, method, etc.), to make use of, to put to use / to use (a person, animal, puppet, etc.), to employ, to handle, to manage, to manipulate / to use (time, money, etc.), to spend, to consume / to use (language), to speak
でしょう	でしょう	it seems, I think, I guess, I wonder / right?, don't you agree?
含む	ふくむ, くくむ	to contain, to comprise, to have, to hold, to include, to embrace / to hold in the mouth / to bear in mind, to understand, to harbor (grudge, etc.), to harbour / to express (emotion, etc.), to imply
すべて	すべて	everything, all, the whole / entirely, completely, wholly, all
昭和	しょうわ	Shōwa era (1926.12.25-1989.1.7) / reminiscent of the Shōwa era, Shōwa-nostalgic, old-fashioned, quaint, old-school
み	み	-ness (as in sweetness), -th (as in warmth) / -ness (as in deepness, weakness), -th (as in depth) / alternating between ... and ...
対応	たいおう	correspondence (to), equivalence / suitability, coordination, matching, being appropriate (for) / dealing with, coping with, handling, response, reception, reaction / compatibility (with technology, software, etc.), capability, support (for)
範囲	はんい	extent, scope, sphere, range, span
通知	つうち	notice, notification, report, posting / notification (on a smartphone, PC, etc.)
をして	をして	indicates patient of a causative expression
状態	じょうたい	state, condition, situation, appearance, circumstances
要素	ようそ	component, factor, item (e.g. in list) / element (e.g. in array), member (e.g. data structure)
場所	ばしょ	place, location, spot, position / room, space / basho, wrestling tournament
プログラム	プログラム	program (of events, music, etc.), programme / program (booklet), brochure, pamphlet / (computer) program, programming
四	し, よん, よ	four, 4
現在	げんざい	the present, present time, now / as of / present tense / this world, this life / to actually exist, to exist right now, to exist right in front of one
べき	べき	should, must, ought to
アメリカ	アメリカ	(United States of) America, United States, US, USA / America (land mass), the Americas
記載	きさい	mention (in a document), record, entry, statement, listing
処理	しょり	processing, dealing with, treatment, disposition, disposal
のうち	のうち	agricultural land, farmland
単位	たんい	unit, denomination / credit (in school) / in units of (e.g. "in thousands"), in amounts of
対象	たいしょう	target, object (of worship, study, etc.), subject (of taxation, etc.)
証明	しょうめい	proof, testimony, demonstration, verification, certification
なく	なく	to cry, to weep, to sob, to howl
子	こ	child, kid, teenager, youngster, young (non-adult) person / (one's) child, offspring / young woman / young (animal) / offshoot / interest / new share / player who is not a dealer (in cards, mahjong, etc.) / young geisha, young prostitute / bird egg / -er (often of young women)
建物	たてもの	building
すべき	すべき	should do, ought to do
とし	とし	town, city, municipal, urban
次に	つぎに	next, then, after that
許可	きょか	permission, approval, authorization, license
報告	ほうこく	report, information
執行	しっこう, しゅぎょう, しゅうぎょう, しぎょう	execution, carrying out, performance, enforcement, exercise, service, conduct / execution / lead monk performing various tasks in a temple
特別	とくべつ	special, particular, extraordinary, exceptional, especial
裁判所	さいばんしょ	court, courthouse
記録	きろく	record, minutes, document / record (e.g. in sports), results, score / to record, to document / to set a record (e.g. in sports), to show a result, to reach a value
表す	あらわす	to represent, to signify, to stand for / to reveal, to show, to display / to express / to make widely known
移動	いどう	movement, transfer, migration, removal, travel / mobile, moving, traveling, travelling, roving
版	はん, ばん	edition, version, printing, impression, implementation (e.g. software) / plate, block, cast / editions of a publication
出題	しゅつだい	setting a question (for an exam, quiz, etc.) / setting a theme (for composition of poetry)
財産	ざいさん	property, fortune, assets
科目	かもく	(school) subject, curriculum, course / item, heading, entry
さらに	さらに	furthermore, again, after all, more and more, moreover, even more
旨	むね	principle, aim, main purpose, central part, pillar / purport, gist, drift, meaning / instructions, orders, intention, wishes
解	かい	solution (of an equation, inequality, etc.), root (e.g. of a polynomial) / solution (to a given problem), answer / explanation, interpretation
カエサル	カエサル	Caesar
作	さく	work (e.g. of art), production / harvest, cultivation, farming, crop, yield / technique
除く	のぞく	to remove, to eliminate, to eradicate / to exclude, to except
でない	でない	is not, am not, are not
生	き	pure, undiluted, raw, crude
文字列	もじれつ	character string
機能	きのう	function, facility, faculty, feature
性	さが	one's nature, one's destiny / custom, tradition, habit, convention
かれ	かれ	he, him / boyfriend
このように	このように	in this manner, in this way, like this
権	けん	right (to do something) / authority, power
変化	へんか	change, variation, alteration, mutation, transition, transformation, transfiguration, metamorphosis / variety, diversity / inflection, declension, conjugation / sidestepping
受ける	うける, ウケる	to receive, to get / to catch (e.g. a ball) / to be struck by (wind, waves, sunlight, etc.) / to sustain (damage), to incur (a loss), to suffer (an injury), to feel (influence) / to undergo (e.g. surgery), to take (a test), to accept (a challenge) / to be given (e.g. life, talent) / to find funny, to find humorous, to be amused (by) / to follow, to succeed, to be descended from / to face (south, etc.) / to be modified by / to obtain (a pawned item, etc.) by paying a fee / to be well-received, to become popular, to go down well
削除	さくじょ	deletion, elimination, erasure, striking out
あるいは	あるいは	or, either ... or / maybe, perhaps, possibly / some ... and others ..., sometimes ... and at other times ...
政令	せいれい	government ordinance, cabinet order
書面	しょめん	document, letter / writing, contents (e.g. of a letter)
まず	まず	first (of all), firstly, to begin with, before anything else / probably, most likely, almost certainly, virtually / more or less (satisfactory), on the whole, reasonably / anyway, at any rate, for now (at least), for the time being
社	やしろ	(Shinto) shrine
法人	ほうじん	corporate body, corporation, (legal) person, (juridical) person
だが	だが	but, however, (and) yet, nevertheless, still, for all that
がな	がな	particle used to indicate the speaker's hope, desire, wish, etc. (e.g. "it would be nice if ...", "I wish there were ...", etc.) / emphatic particle / particle adding uncertainty
引数	ひきすう	argument (e.g. function, program, programme)
設立	せつりつ	establishment, founding / incorporation (of a business)
自分	じぶん	myself, yourself, oneself, himself, herself / I, me / you
言う	いう, ゆう	to say, to utter, to declare / to name, to call / to go (e.g. "the alarm went ping"), to make a noise
け	け	remind me, I forget, was it?, was that what happened?
持	じ	draw (in go, poetry contest, etc.), tie
提出	ていしゅつ	presentation (of documents), submission (of an application, report, etc.), production (e.g. of evidence), introduction (e.g. of a bill), filing, turning in
例えば	たとえば	for example, for instance, e.g.
限り	かぎり	limit, limits, bounds / degree, extent, scope / the end, the last / as long as ..., as far as ..., as much as ..., to the limits of ..., all of ... / unless ... / (not) included in ..., (not) part of ... / ... only (e.g. "one time only", "today only") / end of one's life, final moments, death / funeral, burial
別	べつ, べち	distinction, difference, discrimination / separate, different, another, extra / exception, exclusion / classified by, ranked by, according to
特に	とくに	particularly, especially, in particular, expressly
表現	ひょうげん	expression, presentation / representation, notation
ケ	ケ	counter for the ichi-ni-san counting system (usu. directly preceding the item being counted), noun read using its on-yomi / counter for articles / indicates possessive (esp. in place names)
大	おお	large, big, great, major, important, serious, heavy, loud / older, senior / final, ultimate / rough, broad, general
重要	じゅうよう	important, momentous, essential, principal, major
設定	せってい	establishment, creation, posing (a problem), setting (movie, novel, etc.), scene / options setting, preference settings, configuration, setup
注意	ちゅうい	attention, notice, heed / care, caution, precaution / advice, warning, caution
う	う	indicates speculation / indicates will / indicates invitation
化	か	action of making something, -ification
禁止	きんし	prohibition, inhibition, ban
手	て	hand, arm / forepaw, foreleg / handle / hand, worker, help / trouble, care, effort / means, way, trick, move, technique, workmanship / hand, handwriting / kind, type, sort / one's hands, one's possession / ability to cope / hand (of cards) / direction / move (in go, shogi, etc.)
私	わたし	I, me
とも	とも	certainly, of course, to be sure, surely / even if, no matter (who, what, when, where, why, how), though, although / without even, without so much as / at the (least, earliest, etc.) / also (called), also as / well
効力	こうりょく	effect, efficacy, validity, potency
あるとき	あるとき	on one occasion, once, at one point, at one time
発行	はっこう	publication (of a newspaper, magazine, book, etc.), issue / issue (of banknotes, bonds, passport, etc.) / raising (an event)
金	かね, かな	money / metal
開始	かいし	start, commencement, beginning, initiation
債権者	さいけんしゃ	creditor
債権	さいけん	credit, claim
レベル	レベル	level, standard, amount, degree, grade, rank, class / level (plane), floor, storey (story), layer, stratum / spirit level, (surveyor's) level / minor release sequence number (software versioning) / rebel
となり	となり	next (to), adjoining, adjacent / house next door, neighbouring house, next-door neighbour, next-door neighbor
可能	かのう	possible, potential, practicable, feasible
じ	じ	probably isn't (doesn't, won't, etc.) / will not, must not, don't intend to
音	おと, ね, おん	sound, noise, report / note / fame / Chinese-derived character reading
長	たけ, たき	height, stature / length (esp. of clothing) / all (one has), everything / magnificence (of a waka poem, etc.)
ほか	ほか	other (place, thing, person), the rest, et al. / outside, beyond / nothing except, nothing but, nothing apart from, nothing aside from, no choice (but to) / besides..., in addition to...
ものを	ものを	although, but, even though, I wish that
六	ろく, む, むう	six, 6
位置	いち	place, position, location / position, standing, status, situation
よりも	よりも	in comparison to / rather than
一つ	ひとつ	one / for one thing / only / (not) even / just (e.g. "just try it") / some kind of, one type of
体	からだ	body / torso, trunk / build, physique, frame, figure / health, constitution / corpse, dead body
基	もと	origin, source / base, basis, foundation, root / cause / ingredient, material, base, mix, stock / (someone's) side, (someone's) location / original cost (or capital, principal, etc.) / (plant) root, (tree) trunk / first section of a waka / counter for blades of grass, tree trunks, etc., and for falcons (in falconry) / handle (chopsticks, brush, etc.), grip
ものである	ものである	is something that, is that which
ティ	ティ	tea
程度	ていど	degree, amount, grade, standard, of the order of (following a number), about, approximately
画像	がぞう	image, picture, portrait
取得	とりえ	worth, merit, value, good point, redeeming feature, saving grace
条件	じょうけん	condition, term, requirement, qualification, prerequisite
まれ	まれ	rare, seldom
出し	だし, ダシ	dashi (Japanese soup stock made from fish and kelp) / pretext, excuse, pretense (pretence), dupe, front man
動詞	どうし	verb
複数	ふくすう	plural, multiple, several
良い	よい, えい	good, excellent, fine, nice, pleasant, agreeable / sufficient, enough, ready, prepared / profitable (deal, business offer, etc.), beneficial / OK, all right, fine, no problem / easy to ...
部	ぶ	department (in an organization, company, etc.), division, bureau, faculty / club / part, portion, region, area / category, class, division, section, heading / counter for copies of a newspaper, magazine, book, etc.
持つ	もつ	to hold (in one's hand), to take, to carry / to possess, to have, to own / to maintain, to keep / to last, to be durable, to keep, to survive / to take charge of, to be in charge of / to hold (meeting, etc.), to have (opportunity, etc.) / to have "it", to have that special something, to be blessed with good luck
といい	といい	in terms of both ... and ..., from the perspective of ... as well as ..., whether it be ... or ...
構造	こうぞう	structure, construction, makeup, framework, organization, pattern
物体	ぶったい	object, body, solid
実施	じっし	enforcement, implementation, putting into practice, carrying out, operation, working (e.g. working parameters), enactment
呼び	よび	call, invitation
五	ご, いつ, い	five, 5
エネルギ	エネルギ	energy / energy, strength, power, stamina, get-up-and-go / energy source, energy resource / food energy, calories
無い	ない	nonexistent, not being (there) / unowned, not had, unpossessed / unique / not, impossible, won't happen / not / to not be, to have not
名詞	めいし, なことば	noun
該当	がいとう	corresponding to, being applicable to, being relevant to, coming under, falling under, fulfilling (requirements), meeting (conditions), qualifying for
側	そば, そく, はた	near, close, beside, vicinity, proximity, besides, while / third person
われる	われる	to break, to be smashed / to split, to crack, to fissure, to be torn / to be divided (opinion, vote, etc.), to split (e.g. of a party) / to come to light, to become clear, to be identified, to be revealed / to become distorted (of sound), to clip / to be divisible (without a remainder) / to drop below a minimum
入力	にゅうりょく	input, (data) entry
書く	かく	to write, to compose, to pen / to draw, to paint
一般	いっぱん	general, universal / ordinary, average, common, non-celebrity / the same, no different, (just) as if
たり	たり	-ing and -ing (e.g. "coming and going") / doing such things as... / expresses a command / to be / indicates completion or continuation of an action
ですが	ですが	but, however, (and) yet, nevertheless, still, for all that
のと	のと	ritual prayer, invocation of the gods participating in a rite / congratulatory address
相当	そうとう	corresponding to (in meaning, function, etc.), being equivalent to / appropriate, suitable, befitting, proportionate / to be proportionate to, to be in keeping with, to be deserving of, to be worthy of / considerable, substantial / considerably, rather, quite, fairly, pretty
ズ	ズ	s (pluralizing suffix), es / 's (possessive suffix), s', es'
交付	こうふ	delivery, issuance, handing over, granting
費用	ひよう	cost, expense
のです	のです	the expectation is that ..., the reason is that ..., the fact is that ..., the explanation is that ..., it is that ...
訳注	やくちゅう	translation with notes, translator's notes
用いる	もちいる	to use, to make use of, to utilize, to utilise
引き	ひき	pull, patronage, influence / tug / discount
のに	のに	although, despite, even though, and yet / whereas, while / if only, I wish / in order to
時代	じだい	period, epoch, era, age / the times, those days / oldness, ancientness, antiquity / antique, period piece
図	ず	drawing, picture, diagram, figure, illustration, chart, graph / sight, scene
被保険者	ひほけんしゃ	insured person
書籍	しょせき, しょじゃく	book, publication
をも	をも	even
責任	せきにん	duty, responsibility (incl. supervision of staff) / liability, onus
あまり	あまり	remainder, remnant, rest, balance, surplus, remains (of a meal), leftovers / (not) very, (not) much / too much, excessively, overly / extreme, great, severe, tremendous, terrible / more than, over
量	りょう	quantity, amount, volume, capacity, portion (of food) / generosity, magnanimity, tolerance / pramana, (in Indian philosophy) means by which one gains accurate and valid knowledge
与え	あたえ	gift, godsend
異なる	ことなる	to differ, to vary, to disagree
地域	ちいき	area, region
通常	つうじょう	usual, ordinary, normal, regular, general, common
え	え	eh?, what?, oh? / yes, that's correct / strengthens a question, assertion, etc. / hey
ならば	ならば	if, in case, if it is the case that, if it is true that / as for, on the topic of / if that's the case, if so, that being the case / if possible, if circumstances allow
高い	たかい	high, tall / expensive, high-priced / high (level), above average (in degree, quality, etc.) / loud / high-pitched, shrill
実際に	じっさいに	actually, really, truly, indeed / in practice, practically
オブジェクト	オブジェクト	object
対策	たいさく	measure, step, countermeasure, counterplan, countermove, strategy, preparation (e.g. for a test)
もので	もので	conjunctive particle indicating a cause or reason
東京	とうきょう, とうけい	Tokyo
たが	たが	hoop (of a barrel, bucket, etc.)
学習	がくしゅう	study, learning, tutorial
病理学	びょうりがく	pathology
一方	いっぽう	one (esp. of two), the other, one way, the other way, one direction, the other direction, one side, the other side, one party, the other party / on the one hand, on the other hand / whereas, although, but at the same time, meanwhile, in turn / just keeps, being inclined to ..., tending to be ..., tending to do ..., continuously ..., just keeps on ...ing, only
かっ	かっ	very
のみ	のみ	only, nothing but
設置	せっち	establishment, institution / installation (of a machine or equipment)
すれば	すれば	if so, in that case, in that situation
かつ	かつ	and, moreover, besides, as well as, and on top of that, at the same time
求め	もとめ	request, appeal, claim, demand / purchase
原	げん	original, primitive, primary, fundamental, raw
性質	せいしつ	nature, property, disposition
意見	いけん	opinion, view, comment
入れ	いれ	container, receptacle, case, bag, pouch, box, holder / inserting, putting in
最初	さいしょ	beginning, outset, first, onset
ても	ても	even if, even though / wow
ザ	ザ	the / quintessential, definitive, representative, typical, classic
そのため	そのため	hence, for that reason
事件	じけん	event, affair, incident, case, plot, trouble, scandal
名前	なまえ	name / given name, first name
第四	だいよん	fourth
リンク	リンク	link, linking, linkage / link (on a website), hyperlink / (golf) links
資格	しかく	qualifications, requirements, capabilities
よく	よく	greed, craving, desire, appetite, hunger, avarice, wants
電子	でんし	electron / electronic
宣言	せんげん	declaration, proclamation, announcement
前に	まえに	ahead, before, ago
物質	ぶっしつ	material, substance / matter
株主	かぶぬし	shareholder, stockholder
変換	へんかん	change, conversion, transformation / transformation
方式	ほうしき	form, method, system, formula
措置	そち	measure, step, action
調査	ちょうさ	investigation, examination, inquiry, enquiry, survey
考える	かんがえる	to think (about, of), to think over, to ponder, to contemplate, to reflect (on), to meditate (on) / to consider, to bear in mind, to allow for, to take into consideration / to think (that), to believe, to hold (a view), to judge, to conclude, to suspect / to intend (to do), to think of (doing), to plan / to predict, to anticipate, to expect, to imagine / to come up with, to think up, to contrive, to devise / to consider (as), to regard (as), to look on (as), to take, to view
光	ひかり	light / illumination, ray, beam, gleam, glow / happiness, hope / influence, power / vision, eyesight
給付	きゅうふ	provision (of money or goods), furnishing, conferral, payment, delivery, benefit
にして	にして	only, just because / although, even / at (place, time), in (time span) / and then, moreover, furthermore
んだ	んだ	that's right, yes, uh-huh
入試	にゅうし	entrance examination
事務	じむ	office work, clerical work, administration, business, affairs
わ	わ	indicates emotion or admiration / indicates emphasis / I, me / wah! / boo!
分野	ぶんや	field, sphere, realm, division, branch
はあり	はあり	winged ant, flying ant
にし	にし	west
単語	たんご	word, vocabulary
下	した	below, down, under, younger (e.g. daughter) / bottom / beneath, underneath / just after, right after / inferiority, one's inferior (i.e. one's junior) / trade-in / preliminary, preparatory
べ	べ	word used at sentence-end (like a particle) to indicate speculation, volition or invitation / familiar suffix used after a personal name
しまう	しまう	to finish, to stop, to end, to put an end to, to bring to a close / to close (a business, etc.), to close down, to shut down, to shut up / to put away, to put back, to keep, to store / to do completely, to finish / to do accidentally, to do without meaning to, to happen to do
計画	けいかく	plan, project, schedule, scheme, program, programme
形式	けいしき	form (as opposed to substance) / format, form, style, manner / formality, form / mode, form / form (bilinear, quadratic, etc.)
訴訟	そしょう	litigation, lawsuit
選択	せんたく, せんだく	choice, selection, option
労働者	ろうどうしゃ	employee, worker / laborer (labourer), blue-collar worker
ミ	ミ	mi (3rd note of a major scale in movable-do solfège), me / E (note in the fixed-do system)
システム	システム	system
高	たか, だか	quantity, amount, volume, number, amount of money
作業	さぎょう	work, operation, manufacturing, fatigue duty
クラス	クラス	class
認め	みとめ	approval, acceptance, recognition, acknowledgement / private seal, signet
選任	せんにん	nomination (of a person to a position), selection, election, assignment, appointment
会	え	gathering (esp. Buddhist, festive, etc.)
なか	なか	inside, interior / among, within / middle, center, centre / during, while, middle, midst, amid / interval, gap / mean, average / second (of three, e.g. sons, volumes), middle / medium grade, medium quality / red-light district
ときに	ときに	by the way, incidentally / sometimes, occasionally, on occasion / precisely (at that time), exactly, just (then), right (then)
ヨ	ヨ	I, me
全て	すべて	everything, all, the whole / entirely, completely, wholly, all
元	もと	origin, source / base, basis, foundation, root / cause / ingredient, material, base, mix, stock / (someone's) side, (someone's) location / original cost (or capital, principal, etc.) / (plant) root, (tree) trunk / first section of a waka / counter for blades of grass, tree trunks, etc., and for falcons (in falconry) / handle (chopsticks, brush, etc.), grip
普通	ふつう	normal, ordinary, regular, usual, common, average / normally, ordinarily, usually, generally, commonly / local train, train that stops at every station
権限	けんげん	power, authority, jurisdiction
用語	ようご	term, terminology / wording, choice of words, phraseology
付	つき, づき, ツキ	furnished with, including / attached to / impression, appearance / luck / sociality / under, assistant (e.g. to a manager) / soup base
企業	きぎょう	enterprise, business, company, corporation
提供	ていきょう	offer, tender, providing, supplying, making available, donating (blood, organs, etc.) / sponsoring (a TV program)
細胞	さいぼう, さいほう	cell / cell (in an organization, esp. a communist party)
川	かわ, がわ	river, stream / River, the ... river
金額	きんがく	amount of money, sum of money
ほど	ほど	extent, degree, measure / limit, bounds / (span of) time / (a) distance / the state of, the status of, the condition of / about, around, approximately, or so / as much as ..., to the extent of ..., like ... / the more ... the more ...
支給	しきゅう	provision, supply, payment, allowance, grant
上記	じょうき	above-mentioned, above-named, above
勉強	べんきょう	study / diligence, working hard / experience, lesson (for the future) / discount, price reduction
類	るい	kind, sort, type, class, genus, order, family / similar example, parallel, the like
ドイツ	ドイツ	Germany
よって	よって	therefore, consequently, accordingly, for that reason
支払	しはらい	payment
基礎	きそ	foundation, basis
ないよう	ないよう	contents, content, substance, matter, detail, import
教育	きょういく	education, schooling, training, instruction, teaching, upbringing / culture, cultivation, education
返し	かえし	reversal, return / return gift, return favour (favor) / barb (on a fishing hook) / mixture of soy sauce, sugar and mirin
ものとする	ものとする	shall ... / to assume, to suppose
八	はち, や	eight, 8
判決	はんけつ	judicial decision, judgement, judgment, sentence, decree
後に	のちに	later on, subsequently, by and by, after a while
としては	としては	as (for), for, in the capacity of
一般的	いっぱんてき	general, popular, common, typical
酸	さん	acid / sourness, sour taste
訴え	うったえ	lawsuit, complaint
戦争	せんそう	war / fighting, fierce competition
田	た	rice field
裁判	さいばん	trial, judgement, judgment
負担	ふたん	burden, load, responsibility / bearing (a cost, responsibility, etc.), shouldering
七	しち, なな, ひち, な	seven
市	いち	market, fair
新株予約権	しんかぶよやくけん	share warrant, subscription warrant, call option
債務	さいむ	debt, liabilities, obligation to a person or party (usu. legal or contractual)
款	かん	title, heading, article / benevolence, friendly feeling
ベクトル	ベクトル	vector
起	おこり	source, origin, cause, beginning, genesis
あつ	あつ	thickness
追加	ついか	addition, supplement, appending, appendix
集合	しゅうごう	meeting up, gathering, assembly / set
原因	げんいん, げいいん	cause, origin, source
記号	きごう	symbol, code, sign, notation
構成	こうせい	composition, construction, formation, makeup, structure, organization, organisation
簡単	かんたん	simple, easy, uncomplicated / brief, quick, light
だった	だった	was, were
歩	ふ	pawn
要件	ようけん	important matter / requirement, requisite, necessary condition, sine qua non
人間	にんげん	human being, human, person, man, mankind, humankind / character (of a person)
組み	くみ	class (of students) / group (of people), party, team, crew / lot, bunch, set / crime family, organized-crime syndicate / set (of items), assortment, deck (of cards), pack / typesetting, composition
配列	はいれつ	arrangement, disposition / array
度	たび, たんび	time (three times, each time, etc.), times
転送	てんそう	transfer, redirection, transmission, forwarding (telephone call, e-mail, etc.)
じた	じた	oneself and others, (in philosophy) subject and object / transitivity, transitive and intransitive verbs / first person and third person / self-salvation and salvation by faith
回	かい	counter for occurrences / a time, an instance / inning (baseball), round, game / episode, chapter, instalment / Hui (people) / Islam
はな	はな	flower, blossom, bloom, petal / cherry blossom / beauty / blooming (esp. of cherry blossoms) / ikebana / hanafuda / (the) best / glorious, lovely
約	やく	approximately, about / promise, appointment, engagement / shortening, reduction, simplification / contraction (in phonetics)
コマンド	コマンド	command / command key
行使	こうし	use, exercise (of one's right, authority, power, etc.)
ま	ま	just (e.g. "just wait here"), come now, now, now / tolerably, passably, moderately, reasonably, fairly, rather, somewhat / well..., I think..., it would seem..., you might say..., Hmmm, I guess so... / oh!, oh dear!, oh, my!, wow!, goodness gracious!, good heavens!
同様に	どうように	identically, in the (exact) same way, similarly
イギリス	イギリス	United Kingdom, Britain, Great Britain / England
よ	よ	hey, you / hey / hey, hold on / yo, hey
原子	げんし	atom
取消し	とりけし	cancellation, withdrawal, abolition, revocation, cancel, CAN
ネット	ネット	network / Internet / net (hair, netball, etc.) / net (price, weight, etc.), nett
したり	したり	God bless me!, Good heavens!
当事者	とうじしゃ	person concerned, interested party, related party
したもの	したもの	cheap, low-quality article
同様	どうよう	same, similar, (just) like, equal
安全	あんぜん, あんせん	safety, security
任意	にんい	optional, voluntary, arbitrary, random, discretionary, facultative, spontaneous, any / arbitrary
行列	ぎょうれつ	line, queue, procession, parade / matrix
知識	ちしき	knowledge, information
それら	それら	those (near the second person)
保護	ほご	protection, safeguard, guardianship, custody, patronage / preservation, conservation
中国	ちゅうごく, ちゅうこく	China / Chūgoku region (western part of Honshu comprising the prefectures of Okayama, Hiroshima, Yamaguchi, Tottori and Shimane) / central part of a country, main region / province of the second lowest rank (ritsuryō system)
族	ぞく, ぞう	tribe, clan, band, family / (taxonomical) tribe / group (of the periodic table)
開発	かいはつ, かいほつ	development, exploitation (of resources)
事実	じじつ	fact, truth, reality
検査	けんさ	inspection (e.g. customs, factory), examination, test, check, scan (e.g. MRI, PET), audit
リスト	リスト	list / wrist
おく	おく	inner part, inside, interior, depths (e.g. of a forest), back (of a house, drawer, etc.), bottom (e.g. of one's heart), recesses, heart
のか	のか	endorsing and questioning the preceding statement / lamenting reflections on the preceding statement
有	ゆう	existence / possession, having / limited company
外部	がいぶ	outside (e.g. of a building), exterior / outside (of a group, company, etc.), outside world
日本語	にほんご, にっぽんご	Japanese (language)
数値	すうち	numerical value, numerics / reading (on a meter, etc.)
したい	したい	want to do
さて	さて	well, now, then
示す	しめす	to (take out and) show, to demonstrate, to tell, to exemplify, to make apparent / to point out (finger, clock hand, needle, etc.) / to indicate, to show, to represent, to signify, to display
番号	ばんごう	number, series of digits
学校	がっこう	school
運動	うんどう	exercise, physical training, workout, sports, athletics / appeal, campaign, drive, crusade, movement, lobbying / motion, movement
譲渡	じょうと	transfer, assignment, conveyance
理解	りかい	understanding, comprehension, appreciation / sympathy
成立	せいりつ	formation, establishment, materialization, coming into existence / conclusion (e.g. of a deal), reaching (e.g. an agreement), approval, completion, closing, enacting, arrangement / being valid (of a theory, argument, etc.), holding, applying
利益	りえき, りやく	profit, gains / benefit, advantage, good, interests (e.g. of society) / grace (of God, Buddha, etc., esp. as attained through rightful actions, prayer, adherence to one's faith, etc.), blessing, miracle
申立て	もうしたて	statement, account (of something), declaration, allegation
方向	ほうこう	direction, orientation, bearing, way / course (e.g. of action)
ならない	ならない	cannot help (doing, etc.), cannot resist, cannot bear not to / must not ..., should not ... / must ..., have to ..., ought to ...
